R 1280 720
NO ./testsrcs/north
SO ./testsrcs/south
WE ./testsrcs/west
EA ./testsrcs/east
S ./testsrcs/sprite
C 0,200,200
F 200,200,200

1111111111111111111111111111111111111111
1000000000000000000000000000000000000001
1000000000000000000000001101111000000001
1000010101000000000000001000001000000001
1000000000000000000000001000001000000001
1000010101000000000000001110110000000001
1000000000000000000000000000000000000001
1000000000000000000000000000000000000001
1000000000000000000000000000000000000001
1000000000000000000N00000000000000000001
1000000000000000000000000000000000000001
1000000000000000000000000000000000000001
1000000000000000000000000000000000000001
1000000000000000000000000000000000000001
1000000000000000000000000000000000000001
1111111111111111111111111111111111111111