R 1280 720
NO ./testsrcs/north
SO ./testsrcs/south
WE ./testsrcs/west
EA ./testsrcs/east
S ./testsrcs/sprite
C 0,200,200
F 100,100,100


1111111111
1000000001
1111000001
10000000011111111111111111
100E0000000000000000000001
10000010011111111111111001
100000100111111111    1001
111111100000000001    1111
      100000000001
      100000000001
      100001110111
      100001000001
      100001000001
      111111111111