R  720 480
NO ./textures/bookshelf.xpm
SO ./textures/tnt_side.xpm
WE ./textures/piston_top.xpm
EA ./textures/cracked_stone_bricks.xpm
S ./textures/barrel.xpm
C 51,204,255
F 126,189,0



        1111111111111111111111111
        1000000000110000000000001
        1011000001110000000000001
        1001000000000000000000001
111111111011000001110000000000001
100000000011000001110111111111111
11110111111111011100000010001111111111111111111
11110111111111011101010000001
11000000110101011100000010001111111111111111111
10000000000000001100000010E01
10000000000000001101010010001
1100000111010101111101111000111
11110111 1110101 101111010001
11111111 1111111 111111111111