R 1920 1080
NO ./testsrcs/north
SO ./testsrcs/south
WE ./testsrcs/west
EA ./testsrcs/east
S ./testsrcs/sprite

F 0,0,254
C 25,95,13

        1111111111111111111111111
        1000000000110000000000001
        1011000001110001002000001
        100100000000001 100000001
111111111011000001110001000000001
100000000011000001110111111111111
11110111111111011100000010001
11110111111111011101010010001
11000000110101011100000010001
10002000000000001100000000001
10000000000000001101010010001
11000001110101011111011110N0111
11110111 1110101 101111010001
11111111 1111111 111111111111