R 500 500
NO ./testsrcs/north
SO ./testsrcs/south
WE ./testsrcs/west
EA ./testsrcs/east
S ./testsrcs/sprite
C 0,0,255
F 255,0,0


        1111111111111111111111111
        1000000000110000000000001
        1011000001110000002000001
        1001000000000000000000001
111111111011000001110000000000001
10000000001100000111011111111111
11110111111111011100000010021
11110111111111011101010010001
11000000110101011100000000001
10002000000000001100000010001
10000000000000001101010010N01
1100000111010101111101101000111
11110111 1110101 101111010001
11111111 1111111 111111111111