R           1280               720
NO ./textures/bookshelf.xpm
SO ./textures/tnt_side.xpm
WE ./textures/piston_top.xpm
EA ./textures/cracked_stone_bricks.xpm
S ./textures/barrel.xpm
F 155,62,62
C 51,204,255

11111111111111111111
10000000000102020201
10000000000100000001
10001010000102020201
10001010000100000001
10001010000111001111
100000E0002000000001
10002000000000000001
10000000000000002001
10000020000000000001
11111111111111111111