R 1920 1080
NO ./testsrcs/north
SO ./testsrcs/south
WE ./testsrcs/west
EA ./testsrcs/east
S ./testsrcs/sprite

F 0,0,254
C 25,95,13

11111111111111111111111
11111000000100000000001
111001111N1111111110001
111111 1111       11111