R 1280 720
NO ./testsrcs/north
SO ./testsrcs/south
WE ./testsrcs/west
EA ./testsrcs/east
S ./testsrcs/sprite
C 0,200,200
F 200,200,200





111111111111111
1001000000000001
1000011111111101
1100S1       1001
111101       101
   101       101
   101       101
   101       101
   1011111111101
   10000000000001
    111111111111