R 1280 720
NO ./testsrcs/north
SO ./testsrcs/south
WE ./testsrcs/west
EA ./testsrcs/east
S ./testsrcs/sprite
C 0,200,200
F 100,100,100

                111111111111111
                100000000000001
                101111111111101
                101         101
            1111101111111111101
            1000000000000000001
   11111111110000N0001111111111
   1000000000000000001
   1011111111110111111
   10111111111101
   10000000000001
   11111111111111