R 1920 1080
NO ./testsrcs/north
SO ./testsrcs/south
WE ./testsrcs/west
EA ./testsrcs/east
S ./testsrcs/sprite

F 0,0,254
C 25,95,13

111111
100101
102001
1110N1
111111