R  1280 720
NO ./textures/bookshelf.xpm
C 51,204,255
SO ./textures/tnt_side.xpm
WE ./textures/piston_top.xpm
EA ./textures/cracked_stone_bricks.xpm
S ./textures/barrel.xpm
F 126,189,0



111111
100201
100001
1100N1
111111