R  1280 720
NO ./textures/greystone.xpm
SO ./textures/redstone.xpm
WE ./textures/purplestone.xpm
EA ./textures/eagle.xpm
S ./textures/barrel.xpm
C 0,0,0
F 100,100,100



        1111111111111111111111111
        1000000000110000000000001
        1011000001110000000000001
        1001000000000000000000001
111111111011000001110000000000001
100000000011000001110111111111111
11110111111111011100000010001111111111111111111
111101111111110111010100000000000000000000000001
11000000110101011100000010001111111111111111111
10000000000000001100000010N01
10000000000000001101010010001
1100000111010101111101111000111
11110111 1110101 101111010001
11111111 1111111 111111111111